NO ./path_to_the_north_texture
SO ./path_to_the_south_texture
WE ./path_to_the_west_texture
EA ./path_to_the_east_texture
F 140,255,255
C 140,255,255

11111111111111111111111
10000000000O00000000001
11111111111111111100001
10000000000000000000001
10000000111111111111111
10000000000000000000001
10000000000000000000001
10000000000000000000001
10000000000E00000000001
10000000000000000000001
10000000000000000000001
10000000000000000000001
11111111111111111100001
10000000000000000000001
10000000111111111111111
10000000000000000000001
11111111111111111111111