NO ./path_to_the_north_texture
SO ./path_to_the_south_texture
WE ./path_to_the_west_texture
EA ./path_to_the_east_texture
F 220,100,200
C 12,148,250


        1111111111111111111111111
111111111000000001100000000100011
        1011000001000100000000001
        1001000001000000000000011
1111111110110000000001000000000011111111111111111
100000000011000000000000000111111
11110000000000000000000000001
11110111111110000000000000001
1100001     100111000000000O1
1000001111111000110001111111111
1000000000000000000100000000111
11000001110101011111000000E0101
11110001 1110101 10100000000111
11111111 1111111 11111111111111